X,F,B,X,X,B,X
P,P,P,P,P,P,S
P,F,F,B,F,X,X
P,X,P,P,P,P,P
P,X,P,F,F,F,P
P,F,P,B,X,X,P
P,B,P,F,F,X,P
P,X,P,P,P,F,P
P,X,F,F,P,B,P
P,P,P,P,P,X,H
